20 
**************************************************************
*............................................................*
*............................................................*
*............................................................*
*...************************......************************...*
*............................................................*
*......*...............*.............*................*......*
*......*...............*.............*................*......*
*......*...............*.............*................*......*
*......*...............*.............*................*......*                
*......*...............*.............*................*......*
*......*...............*.............*................*......*
*......*...............*.............*................*......*
*......*...............*.............*................*......*
*............................................................*
*...************************......************************...*
*............................................................*
*............................................................*
*............................................................*
**************************************************************