20 
**************************************************************
*............................................................*
*.**......................................................**.*
*..**....................................................**..*
*...**..................................................**...*
*....**................................................**....*
*.....**.....................****.....................**.....*
*......**...................**..**...................**......*
*.......**.................**....**.................**.......*
*........**...............**......**...............**........*                
*.........**.............**........**.............**.........*
*..........**...........**..........**...........**..........*
*...........**.........**............**.........**...........*
*............**.......**..............**.......**............*
*.............**.....**................**.....**.............*
*..............**...**..................**...**..............*
*...............**.**....................**.**...............*
*................***......................***................*
*............................................................*
**************************************************************