20 
*******************************************************************
*.................................................................*
*.................................................................*
*.................................................................*
*.................................................................*
*.................................................................*
*.................................................................*
*.................................................................*
*.................................................................*
*.................................................................*                
*.................................................................*
*.................................................................*
*.................................................................*
*.................................................................*
*.................................................................*
*.................................................................*
*.................................................................*
*.................................................................*
*.................................................................*
*******************************************************************