20 
**************************************************************
*............................................................*
*............................................................*
*............................................................*
*............................................................*
*............................................................*
*............................................................*
*............................................................*
*............................................................*
*............................................................*                
*............................................................*
*............................................................*
*............................................................*
*............................................................*
*............................................................*
*............................................................*
*............................................................*
*............................................................*
*............................................................*
**************************************************************